111111111111
100C1000C001
10C0100000C1
101110A11101
101000010001
10C000C1EP01
111111111111