11111111
1CCCCCE1
1CPCCCC1
11111111