111111111111
1EPC00000001
111111111111