1111111111111111111111
1P00000000000000000001
10000000000000E0000001
10C0000C000C0000000001
1000000000000000000001
100000000C0A00C0000001
1111111111111111111111