111111111111
1CCCCCCCCCC1
1CCCCCCCCCC1
1CCCCCCCCCC1

1CCCCCCECCP1
111111111111