11111111111111111
10001C00000C1C1E1
10101001010010101
1C100000A000001C1
10101001010010101
1P1C1C00000C100K1
11111111111111111