111111111
100000001
100P00001
100C00001
111111111