1111111
10CEA01
1111111
111P001
1111111