1111111
10CEA01
1111101
111P001
1111111