11111111
1APEC001
10000001
10000001
11111101