11111111111111111
10000000000000001
100000000000000E1
100000000000000A1
100000000000000C1
10000000000000001
11111111111111111