11111111
1CCCCCE1
1CPCA001
11111111