11111111
1CCCCCE1
1CPC0001
11111111